8 10
...X...X.X
X.....XX..
.....X.X..
.X.X.X.XX.
....X.....
X..XXXX..X
.....X....
...X...X..
